#########################################
#           #           #   # #     #   #
# ### ##### ### ####### # ### ### # ### #
# # #     #     #   #     #   #   # #   #
# # ##### ####### # ##### # ### ### # # #
# #   #   #       #   #   #   # #   # # #
# ### # # # ######### ####### # # ### # #
#   # # # # #       #       # # #   # # #
### # # ### # ##### ##### # # # ### # # #
# #   #   # #   # #     # # #   # #   # #
# ### ### # ### # ### # # ####### ##### #
#   #   # #   # #   # # #           #   #
# ##### # ### # ### # ##### ####### # ###
# #     #     #   # #     #   #   # # # #
# # ############# # ### # ### # ### # # #
# # #       #       #   # # # # #   # # #
# # # # ### # ####### ### # # # # ### # #
#   # #   # #   #   # # # # # # #   # # #
# ####### ##### # # # # # # # # ### # # #
# #     #       # #   #   # # #     # # #
# # ### # ####### ##### ### # # ##### # #
#   # # # #     # #   # #   # # #     # #
##### # # ### ### ### # # ### # # ##### #
#   #   #   # #   #   #   #   # # #     #
# ### ##### # # ### ### ### ##### # ### #
#     #   #   # #   #   #   #   #   #   #
# ##### # ##### # # # ### ### # ##### ###
#       #       # #     #     #         #
#########################################
