#################
#   #           #
# # # ######### #
# # #   #   #   #
# ##### # # # # #
#     # # # # # #
# ### # ### # ###
# # #   #   #   #
# # ##### # ### #
#   #   # # #   #
### # # # # # # #
#     #   # # # #
#################
