#################
#         #     #
# ######### ### #
#           #   #
# ########### # #
# #   # #     # #
# # # # # ##### #
#   #   #   # # #
######### # # # #
#       # # # # #
# ##### ### # # #
#     #     #   #
#################
